********************************
*                              *
*                              *
*                              *
*                              *
*                              *
*                              *
*                              *
*                              *
*                              *
*                          *****
*                              *
*                              *
*                    ***       *
*                    *         *
*                    *         *
*                    *         *
*                    *         *
*                              *
*                              *
*                              *
*                              *
*                    *     *   *
*                    ****  *   *
*                       *  *****
*                              *
*                              *
*                              *
*                              *
*                              *
*                              *
********************************
